############################################################
#...........................#..............................#
#...........................#........................W.....#
#.......................@...#..............................#
#.....#######################..............................#
#..........................................................#
#..........................................................#
#..........................................................#
#..........................................................#
#..........................M...............................#
#..........................................................#
#..........................................................#
#.......................................................B..#
############################################################