############################################################
#...........................#..............................#
#...........................#..............................#
#.......................@...#..............................#
#.....#######################..............................#
#..........................................................#
#..........................................................#
#.......................B..................................#
#.................................W........................#
#..........................M...............................#
#..........................................................#
#..........................................................#
#..........................................................#
############################################################